Spells
	Attack Spells (Q,W,E,R)
		paralyze - Q
		flame strike - W
		energy bolt - E
		explosion - shift-E
		lightning - R
		harm - shift-R
		
	Defense Spells (A,S,D, F)
		smart heal - A
		cure - shift-A
		greater heal - S
		heal - shift-S
		invisibility - D
		recall - F
		recall home spell macro - shift-F
		gate - ctrl-alt-F
		smart potion - V
		agility - shift-V
		strength - ctrl-V
		
		plowpouch - f12
		recall home from runebook - f11

Skills (Z,X,C) - this is based on the skills chosen for your character.  
Here is an example Bard Tamer:
	animal taming - C
	provocation - Z
	peacemaking - X
	animal lore - shift-C
	meditation - shift-X
	

Macros
	Arm/Disarm Left Hand - G   (two handed and one-handed weapons)
	Arm/Disarm Right Hand - shift-G  (shields)
	Dress - H
	accept party invitation - P
	Organizer Agent-01 - [    (Regents)
	Organizer Agent-02 - ]   (Gems)
	Organizer Agent-03 - shift-[ (User defined)
	Restock Agent-01 - \  (arrows, regents, bandages, potions)
	Set Restock HotBag-01- ctrl-\

Targetting
	target self - 1
	target last target - 2
	target closest non-friendly - 3
	
	last object - ctrl-1

GUI
  Paperdoll alt - p
  skills alt-k
  backpack alt-i
  minimap alt-r
  
Spell icons pull from spellbook and put on screen
	resurection - gui
	reveal - gui
	magic reflection
	reactive armor - gui
	bless - gui
	arch protection - gui
	mark rune - gui 
	protection - gui
	magic trap - gui  

